25 18 
WWWWWWWWWWWWWWWWWWWWWWWWW
W          W        D   W
W          W            W
W          W            W
WWWW       W            W
W          W            W
W                       W
W          D            W
W               D       W 
W   D                   W
W      D                W
W          W      WWWWWWW
WWW                     W
W          W            W
W          W            W
W          W            W
W                       W
WWWWWWWWWWWWWWWWWWWWWWWWW      